Lines without spaces at the start are ignored
Everything is automatically converted to lowercase also

Recipes are formatted like this:
ItemName | Row 1 - Row 1 - Row 1 / Row 2 - Row 2 - Row 2 / Row 3 - Row 3 - Row 3

/////////////////
//Basic recipes//
/////////////////

 Wood Plank | Wood
 Stick | Wood Plank / Wood Plank
 Crafting Table | Wood Plank - Wood Plank / Wood Plank - Wood Plank
 Furnace | Cobblestone - Cobblestone - Cobblestone / Cobblestone - - Cobblestone  / Cobblestone - Cobblestone - Cobblestone
 Chest | Wood Plank - Wood Plank - Wood Plank / Wood Plank - - Wood Plank / Wood Plank - Wood Plank - Wood Plank
 Torch | Coal / Stick

/////////////////////////
//Manufactures recepies//
/////////////////////////

 Glowstone | Glowstone Dust - Glowstone Dust / Glowstone Dust - Glowstone Dust
 Wool | String - String / String - String
 TNT | Gunpowder - Sand - Gunpowder / Sand - Gunpowder - Sand / Gunpowder - Sand - Gunpowder

 Wood Slab | Wood Plank - Wood Plank - Wood Plank
 Stone Slab | Stone - Stone - Stone
 Sandstone Slab | Sandstone - Sandstone - Sandstone
 Red Sandstone Slab | Red Sandstone - Red Sandstone - Red Sandstone
 Cobblestone Slab | Cobblestone - Cobblestone - Cobblestone
 Brick Slab | Brick - Brick - Brick
 Stone Brick Slab | Stone Brick - Stone Brick - Stone Brick
 Nether Brick Slab | Nether Brick - Nether Brick - Nether Brick
 Quartz Slab | Block of Quartz - Block of Quartz - Block of Quartz
 Purpur Slab | Purpur Block | Purpur Block | Purpur Block

 Wood Stairs | Wood Plank - - / Wood Plank - Wood Plank - / Wood Plank - Wood Plank - Wood Plank
 Stone Stairs | Stone - - / Stone - Stone - / Stone - Stone  - Stone
 Sandstone Stairs | Sandstone - - / Sandstone - Sandstone - / Sandstone - Sandstone - Sandstone
 Red Sandstone Stairs | Red Sandstone - - / Red Sandstone - Red Sandstone - / Red Sandstone - Red Sandstone - Red Sandstone
 Cobblestone Stairs | Cobblestone - - / Cobblestone - Cobblestone - / Cobblestone - Cobblestone - Cobblestone
 Brick Stairs | Brick - - / Brick - Brick - / Brick - Brick - Brick
 Stone Brick Stairs | Stone Brick - - / Stone Brick - Stone Brick - / Stone Brick - Stone Brick - Stone Brick
 Nether Brick Stairs | Nether Brick - - / Nether Brick - Nether Brick - / Nether Brick - Nether Brick - Nether Brick
 Quartz Stairs | Block of Quartz - - / Block of Quartz - Block of Quartz - / Block of Quartz - Block of Quartz - Block of Quartz
 Purpur Stairs | Purpur Block - - / Purpur Block - Purpur Block - / Purpur Block - Purpur Block - Purpur Block

 Snow Block | Snowball - Snowball / Snowball - Snowball
 Snow Layer | Snow - Snow - Snow
 Clay Block | Clay - Clay / Clay - Clay
 Bricks | Brick - Brick / Brick - Brick
 Stone Brick | Stone - Stone / Stone - Stone
 Chiseled Stone Brick | Stone Brick Slab / Stone Brick Slab
 Mossy Stone Brick | Stone Brick - Vines
 Nether Brick Block | Nether Brick - Nether Brick / Nether Brick - Nether Brick
 End Stone Bricks | End Stone - End Stone / End Stone - End Stone
 Purpur Block | Popped Chorus Fruit - Popped Chorus Fruit / Popped Chorus Fruit - Popped Chorus Fruit

 Bookshelf | Wood Plank - Wood Plank - Wood Plank / Book - Book - Book / Wood Plank - Wood Plank - Wood Plank

 Sandstone | Sand - Sand / Sand - Sand
 Smooth Sandstone | Sandstone - Sandstone / Sandstone - Sandstone
 Chiseled Sandstone | Sandstone Slab / Sandstone Slab
 Red Sandstone | Red Sand - Red Sand / Red Sand - Red Sand
 Smooth Red Sandstone | Red Sandstone - Red Sandstone / Red Sandstone - Red Sandstone
 Chiseled Red Sandstone | Red Sandstone Slab / Red Sandstone Slab
 Block of Quartz | Nether Quartz - Nether Quartz / Nether Quartz - Nether Quartz
 Pillar Quartz Block | Block of Quartz / Block of Quartz
 Chiseled Quartz Block | Quartz Slab / Quartz Slab
 Purpur Pillar | Purpur Slab / Purpur Slab
 End Rod | Blaze Rod / Popped Chorus Fruit
 Jack 'o' Lantern | Pumpkin / Torch
 Ender Chest | Obsidian - Obsidian - Obsidian / Obsidian - Eye of Ender - Obsidian / Obsidian - Obsidian - Obsidian
 Anvil | Block of Iron - Block of Iron - Block of Iron / - Iron - / Iron - Iron - Iron
 Beacon | Glass - Glass - Glass / Glass - Nether Star - Glass / Obsidian - Obsidian - Obsidian
 Granite | Diorite - Nether Quartz
 Polished Granite | Granite - Granite / Granite - Granite
 Diorite | Cobblestone - Nether Quartz / Nether Quartz - Cobblestone
 Polished Diorite | Diorite - Diorite / Diorite - Diorite
 Andesite | Cobblestone - Doirite
 Polished Andesite | Andesite - Andesite / Andesite - Andesite
 Coarse Dirt | Dirt - Gravel / Gravel - Dirt

//////////////////////////
//Transportation recipes//
//////////////////////////

 Rail | Iron - - Iron / Iron - Stick - Iron / Iron - - Iron
 Activator Rail | Iron - Stick - Iron / Iron - Redstone Torch - Iron / Iron - Stick - Iron
 Powered Rail | Gold - - Gold / Gold - Stick - Gold / Gold - Redstone - Gold
 Detector Rail | Iron - - Iron / Iron - Stone Pressure Plate - Iron / Iron - Redstone - Iron
 Minecart with Chest | Chest / Minecart
 Carrot on a Stick | Fishing Rod / - Carrot
 Minecart with Furnace | Furnace / Minecart
 Minecart with Hopper | Hopper / Minecart
 Minecart | - - / Iron - - Iron / Iron - Iron - Iron
 Minecart with TNT | TNT / Minecart
 Boat | - - / Wood Plank - - Wood Plank / Wood Plank - Wood Plank - Wood Plank

////////////////
//Tool recipes//
////////////////

 Wood Axe | Wood Plank - Wood Plank - / Wood Plank - Stick - / - Stick -
 Iron Axe | Iron - Iron - / Iron - Stick - / - Stick -
 Gold Axe | Gold - Gold - / Gold - Stick - / - Stick -
 Diamond Axe | Diamond - Diamond - / Diamond - Stick - / - Stick -
 Stone Axe | Cobblestone - Cobblestone - / Cobblestone - Stick - / - Stick -

 Wood Pickaxe | Wood Plank - Wood Plank - Wood Plank / - Stick - / - Stick -
 Iron Pickaxe | Iron - Iron - Iron / - Stick - / - Stick -
 Gold Pickaxe | Gold - Gold - Gold / - Stick - / - Stick -
 Diamond Pickaxe | Diamond - Diamond - Diamond / - Stick - / - Stick -
 Stone Pickaxe | Cobblestone - Cobblestone - Cobblestone / - Stick - / - Stick -

 Wood Shovel | Wood Plank / Stick / Stick
 Iron Shovel | Iron / Stick / Stick
 Gold Shovel | Gold / Stick / Stick
 Diamond Shovel | Diamond / Stick / Stick
 Stone Shovel | Cobblestone / Stick / Stick

 Wood Sword | - Wood Plank - / - Wood Plank - / - Stick -
 Iron Sword | - Iron - / - Iron - / - Stick -
 Gold Sword | - Gold - / - Gold - / - Stick -
 Diamond Sword | - Diamond - / - Diamond - / - Stick -
 Stone Sword | - Cobblestone - / - Cobblestone - / - Stick -

 Wood Hoe | Wood Plank - Wood Plank - / - Stick - / - Stick -
 Iron Hoe | Iron - Iron - / - Stick - / - Stick -
 Gold Hoe | Gold - Gold - / - Stick - / - Stick -
 Diamond Hoe | Diamond - Diamond - / - Stick - / - Stick -
 Stone Hoe | Cobblestone - Cobblestone - / - Stick - / - Stick -

 Flint and Steel | Iron - / - Flint
 Bucket | Iron - - Iron / - Iron -
 Compass | - Iron - / Iron - Redstone - Iron / - Iron -

 Map | Paper - Paper - Paper / Paper - Compass - Paper / Paper - Paper - Paper
 Map (zoomed out) | Paper - Paper - Paper / Paper - Map - Paper / Paper - Paper - Paper
 Clock | - Gold - / Gold - Redstone - Gold / - Gold -
 Fishing Rod | - - Stick / - Stick - String / Stick - - String
 Shears | - Iron / Iron -
 Fire Charge | Blaze Powder - Coal / - Gunpowder

 Bow | - Stick - String / Stick - - String / - Stick - String
 Arrow | Flint / Stick / Feather
 Spectral Arrow | - Glowstone Dust - / Glowstone Dust - Arrow - Glowstone Dust / - Glowstone Dust - 
 Tipped Arrow | Arrow - Arrow - Arrow / Arrow - Lingering Potion - Arrow / Arrow - Arrow - Arrow

 Shield | Wood Plank - Iron - Wood Plank / Wood Plank - Wood Plank - Wood Plank / - Wood Plank - 

 Leather Helmet | Leather - Leather - Leather / Leather - - Leather
 Gold Helmet | Gold - Gold - Gold / Gold - - Gold
 Chainmail Helmet | Fire - Fire - Fire / Fire - - Fire
 Iron Helmet | Iron - Iron - Iron / Iron - - Iron
 Diamond Helmet | Diamond - Diamond - Diamond / Diamond - - Diamond

 Leather Leggings | Leather - Leather - Leather / Leather - - Leather / Leather - - Leather
 Gold Leggings | Gold - Gold - Gold / Gold - - Gold / Gold - - Gold
 Chainmail Leggings | Fire - Fire - Fire / Fire - - Fire / Fire - - Fire
 Iron Leggings | Iron - Iron - Iron / Iron - - Iron / Iron - - Iron
 Diamond Leggings | Diamond - Diamond - Diamond / Diamond - - Diamond / Diamond - - Diamond

 Leather Chestplate | Leather - - Leather / Leather - Leather - Leather / Leather - Leather - Leather
 Gold Chestplate | Gold - - Gold / Gold - Gold - Gold / Gold - Gold - Gold
 Chainmail Chestplate | Fire - - Fire / Fire - Fire - Fire / Fire - Fire - Fire
 Iron Chestplate | Iron - - Iron / Iron - Iron - Iron / Iron - Iron - Iron
 Diamond Chestplate | Diamond - - Diamond / Diamond - Diamond - Diamond / Diamond - Diamond - Diamond

 Leather Boots | Leather - - Leather / Leather - - Leather
 Gold Boots | Gold - - Gold / Gold - - Gold
 Chainmail Boots | Fire - - Fire / Fire - - Fire
 Iron Boots | Iron - - Iron / Iron - - Iron
 Diamond Boots | Diamond - - Diamond / Diamond - - Diamond

/////////////////////
//Mechanism recipes//
/////////////////////

 Wooden Trapdoor | - - / Wood Plank - Wood Plank - Wood Plank / Wood Plank - Wood Plank - Wood PLank
 Iron Trapdoor | Iron - Iron / Iron - Iron
 Wooden Pressure Plate | Wood Plank - Wood Plank
 Stone Pressure Plate | Stone - Stone
 Weighted Pressure Plate | Iron - Iron
 Weighted Pressure Plate (Gold) | Gold - Gold
 Button | Stone
 Wooden Button | Wood Plank
 Note Block | Wood Plank - Wood Plank - Wood Plank / Wood Plank - Redstone - Wood Plank / Wood Plank - Wood Plank - Wood Plank
 Jukebox | Wood Plank - Wood Plank - Wood Plank / Wood Plank - Diamond - Wood Plank / Wood Plank - Wood Plank - Wood Plank

 Dispenser | Cobblestone - Cobblestone - Cobblestone / Cobblestone - Bow - Cobblestone / Cobblestone - Redstone - Cobblestone
 Dropper | Cobblestone - Cobblestone - Cobblestone / Cobblestone - - Cobblestone / Cobblestone - Redstone - Cobblestone
 Piston | Wood Plank - Wood Plank - Wood Plank / Cobblestone - Iron - Cobblestone / Cobblestone - Redstone - Cobblestone
 Sticky Piston | Slimeball / Piston
 Redstone Lamp | - Redstone - / Redstone - Glowstone - Redstone / - Redstone -
 Redstone Torch | Redstone / Stick
 Lever | Stick / Cobblestone
 Tripwire Hook | - Iron - / - Stick - / - Wood Plank -
 Daylight Sensor | Glass - Glass - Glass / Nether Quartz - Nether Quartz - Nether Quartz / Wood Slab - Wood Slab - Wood Slab
 Hopper | Iron - - Iron / Iron - Chest - Iron / - Iron -
 Trapped Chest | Tripwire Hook - Chest

 Wood Door | Wood Plank - Wood Plank / Wood Plank - Wood Plank / Wood Plank - Wood Plank
 Iron Door | Iron - Iron / Iron - Iron / Iron - Iron

 Redstone Repeater | - - / Redstone Torch - Redstone - Redstone Torch / Stone - Stone - Stone
 Redstone Comparator | - Redstone Torch - / Redstone Torch - Nether Quartz - Redstone Torch / Stone - Stone - Stone

////////////////
//Food recipes//
////////////////

 Bowl | - - / Wood Plank - - Wood Plank / - Wood Plank -
 Mushroom Stew | Red Mushroom - Brown Mushroom / - Bowl
 Rabbit Stew | - Cooked Rabbit - / Carrot - Baked Potato - Mushroom / - Bowl -
 Beetroot Soup | Beetroot - Beetroot - Beetroot / Beetroot - Beetroot - Beetroot / - Bowl -

 Bread | Wheat - Wheat - Wheat
 Sugar | Sugar Cane
 Cake | Milk - Milk - Milk / Sugar - Egg - Sugar / Wheat - Wheat - Wheat
 Cookie | Wheat - Cocoa Beans - Wheat
 Golden Apple | Gold - Gold - Gold / Gold - Apple - Gold / Gold - Gold - Gold
 Enchanted Golden Apple | Gold Block - Gold Block - Gold Block / Gold Block - Apple - Gold Block / Gold Block - Gold Block - Gold Block
 Melon Seeds | Melon
 Pumpkin Seeds | Pumpkin
 Pumpkin Pie | Egg - / Sugar - Pumpkin
 Hay Bale | Wheat - Wheat - Wheat / Wheat - Wheat - Wheat / Wheat - Wheat - Wheat
 Wheat | Hay Bale
 Golden Carrot | Gold Nugget - Gold Nugget - Gold Nugget / Gold Nugget - Carrot - Gold Nugget / Gold Nugget - Gold Nugget - Gold Nugget
 Baked Potato | jacob614 - / Furnace - Coal

/////////////////////////
//Miscellaneous recipes//
/////////////////////////

 Block of Gold | Gold - Gold - Gold / Gold - Gold - Gold / Gold - Gold - Gold
 Block of Iron | Iron - Iron - Iron / Iron - Iron - Iron / Iron - Iron - Iron
 Diamond Block | Diamond - Diamond - Diamond / Diamond - Diamond - Diamond / Diamond - Diamond - Diamond
 Lapis Lazuli Block | Lapiz Lazuli - Lapiz Lazuli - Lapiz Lazuli / Lapiz Lazuli - Lapiz Lazuli - Lapiz Lazuli / Lapiz Lazuli - Lapiz Lazuli - Lapiz Lazuli
 Block of Emerald | Emerald - Emerald - Emerald / Emerald - Emerald - Emerald / Emerald - Emerald - Emerald
 Block of Redstone | Redstone - Redstone - Redstone / Redstone - Redstone - Redstone / Redstone - Redstone - Redstone
 Block of Coal | Coal - Coal - Coal / Coal - Coal - Coal / Coal - Coal - Coal
 Slime Block | Slimeball - Slimeball - Slimeball / Slimeball - Slimeball - Slimeball / Slimeball - Slimeball - Slimeball
 Melon Block | Melon - Melon - Melon /  Melon - Melon - Melon /  Melon - Melon - Melon

 Lead | String - String - / String - Slimeball - / - - String
 Ladder | Stick - - Stick / Stick - Stick - Stick / Stick - - Stick
 Glass Pane | Glass - Glass - Glass / Glass - Glass - Glass
 Iron Bars | - - / Iron - Iron - Iron / Iron - Iron - Iron 
 Wood Fence | - - / Wood Plank - Stick - Wood Plank / Wood Plank - Stick - Wood Plank
 Nether Brick Fence | - - / Nether Brick - Nether Brick - Nether Brick / Nether Brick - Nether Brick - Nether Brick
 Fence Gate | - - / Stick - Wood Plank - Stick / Stick - Wood Plank - Stick
 Cobblestone Wall | - - / Cobblestone - Cobblestone - Cobblestone / Cobblestone - Cobblestone - Cobblestone
 Mossy Cobblestone Wall | - - / Moss Stone - Moss Stone - Moss Stone / Moss Stone - Moss Stone - Moss Stone
 Moss Stone | Cobblestone - Vines

 Iron | Iron Block
 Gold | Gold Block
 Diamond | Block of Diamond
 Lapiz | Lapiz Lazuli Block
 Emerald | Block of Emerald
 Redstone | Block of Redstone
 Slimeball | Slime Block

 Painting | Stick - Stick - Stick / Stick - Wool - Stick / Stick - Stick - Stick
 Item Frame | Stick - Stick - Stick / Stick - Leather - Stick / Stick - Stick - Stick
 Sign | Wood Plank - Wood Plank - Wood Plank / Wood Plank - Wood Plank - Wood Plank / - Stick -
 Armor Stand | Stick - Stick - Stick / - Stick - / Stick - Stone Slab - Stick

 Paper | Sugar Cane - Sugar Cane - Sugar Cane
 Book | Paper - Paper / Paper - Leather
 Book and Quill | Feather - / Ink Sac - Book
 Leather | Rabbit Hide - Rabbit Hide / Rabbit Hide - Rabbit Hide
 Bed | Wool - Wool - Wool / Wood Plank - Wood Plank - Wood Plank
 Gold | Gold Nugget - Gold Nugget - Gold Nugget / Gold Nugget - Gold Nugget - Gold Nugget / Gold Nugget - Gold Nugget - Gold Nugget
 Eye of Ender | Ender Pearl / Blaze Powder
 End Crystal | Glass - Glass - Glass / Glass - Eye of ender - Glass / Glass - Ghast Tear - Glass
 Flower Pot | - - / Brick - - Brick / - Brick -
 Banner | Wool - Wool - Wool / Wool - Wool - Wool / - Stick -

 Sea Lantern | Prismarine Shard - Prismarine Crystals - Prismarine Shard / Prismarine Crystals - Prismarine Crystals - Prismarine Crystals / Prismarine Shard - Prismarine Crystals - Prismarine Shard
 Prismarine | Prismarine Shard - Prismarine Shard / Prismarine Shard - Prismarine Shard
 Prismarine Brick | Prismarine Shard - Prismarine Shard - Prismarine Shard / Prismarine Shard - Prismarine Shard - Prismarine Shard / Prismarine Shard - Prismarine Shard - Prismarine Shard
 Dark Prismarine | Prismarine Shard - Prismarine Shard - Prismarine Shard / Prismarine Shard - Ink Sac - Prismarine Shard / Prismarine Shard - Prismarine Shard - Prismarine Shard

///////////////
//Dye recipes//
///////////////

 Bone Meal | Bone
 Light Gray Dye | Bone Meal / Ink Sac - Bone Meal
 Light Gray Dye 2 | Gray Dye - Bone Meal
 Gray Dye | Ink Sac - Bone Meal
 Red Dye | Red Tulip
 Red Dye (var.) | Poppy
 Red Dye (var. 2) | Rose Bush
 Red Dye (var. 2) | Beetroot
 Orange Dye | Red Dye - Yellow Dye
 Orange Dye (var.) | Orange Tulip
 Yellow Dye | Dandelion
 Yellow Dye (var.) | Sunflower
 Lime Dye | Green Dye - Bone Meal
 Light Blue Dye | Lapiz Lazuli - Bone Meal
 Cyan Dye | Lapiz Lazuli - Green Dye
 Purple Dye | Lapiz Lazuli - Red Dye
 Magenta Dye | Pink Dye / Purple Dye
 Magenta Dye (var.) | Lilac
 Magenta Dye (var. 2) | Allium
 Magenta Dye (var. 3) | Lapiz Lazuli - Bone Meal / Red Dye - Red Dye
 Magenta Dye (var. 4) | Lapiz Lazuli - / Pink Dye - Red Dye
 Pink Dye | Pink Tulip
 Pink Dye (var.) | Peony
 Pink Dye (var. 2) | Red Dye - Bone Meal
 Cactus Green | Cactus - / Furnace - Coal

////////////////
//Wool recipes//
////////////////

 Orange Wool | White Wool - Orange Dye
 Magenta Wool | White Wool - Magenta Dye
 Light Blue Wool | White Wool - Light Blue Dye
 Yellow Wool | White Wool - Yellow Dye
 Lime Wool | White Wool - Lime Dye
 Pink Wool | White Wool - Pink Dye
 Gray Wool | White Wool - Gray Dye
 Light Gray Wool | White Wool - Light Gray Dye
 Cyan Wool | White Wool - Cyan Dye
 Purple Wool | White Wool - Pueple Dye
 Blue Wool | White Wool - Lapis Lazuli
 Brown Wool | White Wool - Cocoa Beans
 Green Wool | White Wool - Cactus Green
 Red Wool | White Wool - Red Dye
 Black Wool | White Wool - Ink Sac
 Carpet | Wool - Wool

//////////////////////
//Dyed Block Recipes//
//////////////////////
 Stained Clay | Hardened Clay - Hardened Clay - Hardened Clay / Hardened Clay - Dye - Hardened Clay / Hardened Clay - Hardened Clay - Hardened Clay
 Stained Glass | Glass - Glass - Glass / Glass - Dye - Glass / Glass - Glass - Glass
 Stained Glass Panes | Stained Glass - Stained Glass - Stained Glass / Stained Glass - Stained Glass - Stained Glass

///////////////////////////////////
//Enchantment and brewing recipes//
///////////////////////////////////

 Enchantment Table | - Book - / Diamond - Obsidian - Diamond / Obsidian - Obsidian - Obsidian
 Glass Bottle | Glass - - Glass / - Glass -
 Cauldron | Iron - - Iron / Iron - - Iron / Iron - Iron - Iron

 Brewing Stand | - - / - Blaze Rod - / Cobblestone - Cobblestone - Cobblestone
 Blaze Powder | Blaze Rod
 Magma Cream | Slimeball / Blaze Powder
 Fermented Spider Eye | Spider Eye - Brown Mushroom / - Sugar
 Glistering Melon | Gold Nugget - Gold Nugget - Gold Nugget / Gold Nugget - Melon - Gold Nugget / Gold Nugget - Gold Nugget - Gold Nugget
 Gold Nugget | Gold
